green:3,C,D
cyan:4,F,E
pink:5,G,H
magenta:6,I,J
orange: 7,L,M
yellow: 8,N,O,2
+++++++++++++++++++++++++++++++
+ 2                +           +
+                 +++++++++++++
+                            V+
+                 + +++++++++ +
+v                  +       +1+
+                           +K+
+0                     F    +k+
+++++++++++++++++++++++++++++++
+3Cc+eE4  +5Gg+6Ii +7Ll+8Nn   +
+ D +     +   +    +  M+ O    +
+   +  F  + H +   J+   +     F+
+++++++++++++++++++++++++++++++