blue:0,A,B,V
red:1,2,K
green:3,C,D
cyan:4,F,E
pink:5,G,H
magenta:6,I,J
+++++++++++++++++++++++++++++++
+2K                           +
+K+ + + + + + + + + + + + + + +
+                             +
+ + + + + + + + + + + + + + + +
+                             +
+ + + + + + + + + + + + + + + +
+                             +
+++++++++++++++++++++++++++++++
+                 +           +
+                 +++++++++++++
+                            V+
+                 + +++++++++ +
+v                  +       +1+
+                           +K+
+0                     F    +k+
+++++++++++++++++++++++++++++++
+3Cc+eE4                      +
+ D +                         +
+   +  F                   F  +
+++++++++++++++++++++++++++++++