blue:0,A,B,C,D,E,F,H,I,J,K,V
red:1,2,G
+++++++++++++++++++++++++++++++
+                             +
+ + + + + + + + + + + + + + + +
+                             +
+ + + + + + + + + + + + + + + +
+                             +
+ + + + + + + + + + + + + + + +
+                             +
+++++++++++++++++++++++++++++++
+gE               +           +
+aD         J     + +++++++++V+
+BC               + +      G+ +
+     H           +A+ v     + +
+0F       I                 + +
+++++++++++++++++++++++++++++ +
+K               2        1   +
+++++++++++++++++++++++++++++++