blue:0,A,B

+++++++++++++++++++++++++++++++
+                   bB        +
++++++++++++++                +
+                    0Aa      +
+++++++++++++++++++++++++++++++
+C                           c+
+C                           c+
+C                           c+
+C                           c+
+C                           c+
+C                           c+
+C                           c+
+C                           c+
+C                           c+
+C                           c+
+C                           c+
+C                           c+
+C                           c+
+C                           c+
+C                           c+
+C                           c+
+                             +
+1                            +
+++++++++++++++++++++++++++++++