blue:0,A,B,C,D,E,F,H,I,J,K,V
red:1,2,G
+++++++++++++++++++++++++++++++
+                             +
+ + + + + + + + + + + + + + + +
+                             +
+ + + + + + + + + + + + + + + +
+                             +
+ + + + + + + + + + + + + + + +
+                             +
+++++++++++++++++++++++++++++++
+g     AbB        +           +
+                 +++++++++++++
+                             +
+a                + +++++++++V+
+v                  +      G+ +
+                           +1+
+0                          + +
+++++++++++++++++++++++++++++ +
+K                          + +
+++++++++++++++++++++++++++++++