+++++++++++++++++++++++++++++++++++++++++++
+                              Cc+       b+
+  B                    ++++++++ + ++++++++
+ +++++++++++++++++++++ ++++++++   +
+ +                   +0+      +++++
+ +++++++++++++++++++++++++++++++++++++++++
+ E       e                               +
+ E            e                          +
+ E            e                          +
+ E            e                          +
+ E                     e                 +
+ E                     e                 +
+ E                        e              +
+ E                        e              +
+ E                                   e   +
+ E                                    e  +
+ E                                     e +
+ E                                      e+
+ E                                      e+
+ E                                      e+
+ E                                      e+
+ E                                      e+
+ E                                      e+
+ E                                      e+
+ E                                      e+
+ E                                      e+
+ E                                      e+
+ E                                      e+
+ E                                      e+
+ E                                      e+
+ E                                      e+
+ E                                      e+
+ E                                      e+
+ E                                      e+
+ E                                      e+
+ E                                      e+
+ E                                      e+
+++++++++++ +++++++++++++++++++++++++++++++
++ +++++++                     +       +
++b+++++++                     +       +
++c+++++++                     +   K   +
++    ++++                     +   A   +
+++++ ++++                     +   L   +
++    ++++C                    +   D   +
++ +++++++                     +   I   +
++                             +       +
++++++++++                     +       +
++++++++++                    B+       +
++++++++++++++++++++++++++++++++++++++++
