blue: 0,A,B
red: 1,C
++++++++++++++++++++++
+aA0              bB1+
+++++++ +++++++++ ++++
+++++++C++++++++++++++
+++++++c++++++++++++++
++++++++++++++++++++++
