blue: 0,3,A,B
red: 1,C,D
yellow: 2,E
+++++++++++++++++++++++++++++++++
+ 1 +E          e+aaaaaaaaaaaaaa+
+   +E          e+              +
++ ++E          e+              +
++ ++E          e+              +
++B++            +AAAAAAAAAAAAAA+
+                               +
+                               +
+         0                     +
+                               +
+                               +
++D++            +CCCCCCCCCCCCCC+
++ ++            +              +
++ ++            +              +
+   +            +              +
+ 2 +            +cccccccccccccc+
+++++++++++++++++++++++++++++++++