blue: 0,A,B
red: 1,C,D
yellow: 2,E
+++++++++++++++++++++++++++++++++
+ 1 +E          e+aaaaaaaaaaaaaa+
+   +E          e+              +
++ ++E          e+              +
++B++E          e+              +
++ ++E          e+AAAAAAAAAAAAAA+
+                               +
+                               +
+                              0+
+                               +
+                               +
++ ++            +CCCCCCCCCCCCCC+
++D++            +              +
++ ++            +              +
+   +            +              +
+ 2 +            +cccccccccccccc+
+++++++++++++++++++++++++++++++++