+++++++++
+0Aa+++++
+     +++
+1    Bb+
+++++++++
