blue: 0,A,B
red: 1,C
yellow: 2,D,E
green: 3,F
++++++++++++++++++++++++++++++++++++++
+ AAAAAAA   C++++++++   +2          f+
+               B      1+  D        d+
+            ++++++++   +  D        d+
+            ++++++++++++  D        d+
+0           ++++++++++++  D        d+ 
+            + F  +++++++  D        d+
+            + 3      E              +      
+ aaaaaaa   c+    +++++++            +
++++++++++++++++++++++++++++++++++++++