++++++++++++++
+0 A   a    ++
++++++++++++++
+1    Bb+
+++++++++
++++++++++++++
+2 A        a+
++++++++++++++
