red: 0,A,C
blue: 1,B,D
+++++++++++++++++++
+c dD     0       +
+++++       +++   +
+   ++++     +   +
+       +++C      +
++++++++++++++++  +
+        +        +
+    +    B  ++++++
+            Aa  b+
+   ++       ++++++
+       +++       +
+        1        +
+++++++++++++++++++
