++++++++++++++++++++++++
+++++++++++++          +
+++++++++++++          +
+                      +
++++++++++++++++++++++++
+abcdef      A         +++++++
+++++++++++++   0       BCDEF+
+++++++++++++          +++++++
++++++++++++++++++++++++
