++++++++++++++++++++++++
+++++++++++++          +
+++++++++++++          +
+a bB     0            +
+++++++++++++          +
+deE         1         +
+++++++++++++       Cc +
+++++++++++++          +
+++++++++++++          +
+++++++++++++  A     D +
++++++++++++++++++++++++
