+++++++++++++++++++++++++++++++
+a                           A+
+                             +
+                             +
+    EF  0                    +
+    DCB          K           +
+    HGI        J   L   M     +
+++++++++++++++++++++++++++++++