+++++++++++++++++++++++++++++++++++++++++++
+                              Cc+       b+
+  B                    ++++++++ + ++++++++
+ +++++++++++++++++++++ +      +   +
+ +     K A L D I     +0++++++++++++
+ +++++++++++++++++++++++++++++++++++++++++
+ E       e                               +
+ E            e                          +
+ E            e                          +
+ E            e                          +
+ E                     e                 +
+ E                     e                 +
+ E                        e              +
+ E                        e              +
+ E                                   e   +
+ E                                    e  +
+ E                                     e +
+ E                                      e+
+ E                                      e+
+ E                                      e+
+ E                                      e+
+ E                                      e+
+ E                                      e+
+ E                                      e+
+ E                                      e+
+ E                                      e+
+ E                                      e+
+ E                                      e+
+ E                                      e+
+ E                                      e+
+ E                                      e+
+ E                                      e+
+ E                                      e+
+ E                                      e+
+ E                                      e+
+ E                                      e+
+ E                                      e+
+++++++++   +++++++++++++++++++++++++++++++
++ i h ++                     +
++j++++++                     +
++klns+++                     +
+++++r+++                     +
++   p+++                     +
++ ++++++                     +
++     o                      +
+++++++++ H I J K L N S R P O +
+++++++++++++++++++++++++++++++