++++++++++++++++++
+               0+
+               A+
+     ++++++++++++
+               a+
+      +++++++++++
++++++++++++++++++
