+++++++++++++++
+++++++       +
+++++++       +
+b a c    0CAB+
++++++++      +
++++++++      +
+++++++++++++++
