++++++++++++++++++++++++
+++++++++++++          +
+++++++++++++          +
+a bB     0            +
+++++++++++++          +
+deE                   +
+++++++++++++          +
+++++++++++++          +
+++++++++++++          +
+++++++++++++  A     D +
++++++++++++++++++++++++
