++++++++++++++++++++++++
+++++++++++++          +
+++++++++++++          +
+a Bb  c d   0       +
+++++++++++++          +
+++++++++++++          +
+++++++++++++          +
+++++++++++++          +
+++++++++++++          +
+++++++++++++  A  C  D +
++++++++++++++++++++++++
