+++++++++++++++++++
+ +               +
+ +            ++++
+ +           0A  +
+              ++a+
+               + +
+            ++++++
+            Aa   +
+            ++++++
+                 +
+ +               +
+++++++++++++++++++
