+++++++++++++++++++
+0    A           +
+ +               +
+ +               +
+a+++++++++++++++ +
+++               +
+   +++++++++++++++
+                 +
+                A+
+++++++++++++++++++

