+++++++++++++++++++
+0    A           +
+ +               +
+ +               +
+a+++++++++++++++ +
+++               +
+   +++++++++++++++
+                 +
++++++++++++++    +
+                 +
+                 +
+                 +
+   +++++++++++++++
+                 +
+    +    A       +
+        +        +
+                 +
+       A  +      +
+                 +
+    +           A+
+++++++++++++++++++

