++++++++++++++++++++++++++++++++++++
+           Aa                     +
+ +++++++++++++++++++++++++++++++  +
+ +                             +  +
+ +                             +  +
+ +                             +  +
+ +                             +  +
+ +                             +  +
+ +                             +  +
+ +                             +  +
+ +                             +  +
+ +                             +  +
+ +                             +  +
+ +                             +  +
+                                  +
+               0                  +
++++++++++++++++++++++++++++++++++++
