++++++++++++++++++++++++++++++++++++
+           Aa                     +
+ +++++++++++++++++++++++++++++++  +
+ +++++++++++++++++++++++++++++++  +
+ +++++++++++++++++++++++++++++++  +
+ +++++++++++++++++++++++++++++++  +
+ +++++++++++++++++++++++++++++++  +
+ +++++++++++++++++++++++++++++++  +
+ +++++++++++++++++++++++++++++++  +
+ +++++++++++++++++++++++++++++++  +
+ +++++++++++++++++++++++++++++++  +
+ +++++++++++++++++++++++++++++++  +
+ +++++++++++++++++++++++++++++++  +
+ +++++++++++++++++++++++++++++++  +
+ +++++++++++++  ++++++++++++++++ +
+               0                  +
++++++++++++++++++++++++++++++++++++
