++++++++++++
+0A       a+
+ A       a+
+ B       b+
+ A       a+
+ C       c+
+ A       a+
+ B       b+
+ A       a+
+ C       c+
+ A       a+
++++++++++++